NO ./xpm/north.xpm
SO ./xpm/south.xpm
WE ./xpm/west.xpm
EA ./xpm/east.xpm

F 225,30,0
C 0,255,255

111111111111
100000000001
100000000001
100000000001
100000000001
100000000001
100000000001
100000000001
1000N0000001
111111111111
