NO ./assets/Wall_NO.xpm
SO ./assets/Wall_SO.xpm
WE ./assets/Wall_WE.xpm
EA ./assets/Wall_EA.xpm

C 135,206,235
F 67,205,94

        1111111111111111111111111
        1000000000110000000000001
        1011000001110000000000001
        1001000000000000000000001
11111111101100000111000000000000111111
1000000000110000011100000000000000000111111111111
1111011111111101110000001000000000000000000000001
1111011111111101110101001000000000000000000000001
1100000011010101110000000000000000000000000000001
1100000011010101110000000000000000000000000000001
1100000011010101110000000000000000000000000000001
1100000011010101110000000000000000000000000000001
1100000011010101110000000000000000000000000000001
1000000000000000110000000000000000000000000000001
1000000001000000001010N00000000000000000000000001
1100000110101011111011110000000000000000000000111
11110111 1111101 10111101000000000000000000000001
1111111 1111 111111111111111111111111111111111111
