NO ./assets/Wall_NO.xpm
SO ./assets/Wall_SO.xpm
WE ./assets/Wall_WE.xpm
EA ./assets/Wall_EA.xpm

F 67,135,94
C 135,206,235


 111111
10000S1
10111011
101 101
1011101
1000001
111111 